    #####   
   ## @ ##  
 ###  #  ###
 #   ###   #
 #$   #    #
 # ####### #
## . ###   #
#.$ * #  ###
#  .  #  ## 
###  ###  # 
 #  ##### ##
 #      $  #
 ##  ###   #
  ##########
